NO	./textures/colorstone.xpm
SO	./textures/redbrick.xpm
WE	./textures/yellowstone.xpm
EA	./textures/mossy.xpm



F 255, 0, 0
C 0, 0, 255

111111111111111111111111
111111111111111111111111
111111111111111111111111
1000000001    1N00000111
0000000001
100000000000000000000101
111111111111111111111111
